................................
................................
..RRR......................RRR..
..RR.......................RRR..
..RRR......................R.R..
................................
................................
................................
................................
................................
................................
................................
............RRRRRRRR............
............RRRRRRRR............
............RRRRRRRR............
............RRRRRRRR............
............RRRRRRRR............
............RRRRRRRR............
............RRRRRRRR............
............RRRRRRRR............
............RRRRRRRR............
............RRRRRRRR............
............RRRRRRRR............
............RRRRRRRR............
............RRRRRRRR............
................................
................................
................................
................................
................................
................................
................................