SSSSSSSSSSSS
S      S   S
S SSS  SSS S
S S S      S
S S SSS SS S
S S  S   S S
S SS SSS S S
S  S   SSS S
SSSSSS   S S
S    SSSSS S
S  S       S
SSSSSSSSSSSS