SSSSSSSSSSSS
S          S
S SSSSSS   S
S S        S
S SSSS   S S
S    S   S S
S SS SSS S S
SSS    S S S
SS   S S S S
S   SS SSS S
S  SS      S
SSSSSSSSSSSS