SSSSSSSSSSSS
S  S S  S  S
S SS SS SS S
SSS   S  SSS
S   SSSS   S
S SSS  S S S
S S S  SSS S
S   SSSS   S
SSS  S   SSS
S SS SS SS S
S  S    S  S
SSSSSSSSSSSS