SSSSSSSSSSSS
S  S    SS S
SS S SS    S
S       SS S
SS SSS SS  S
S  S   S  SS
S SSSS   SSS
S      S S S
SSS S SS   S
SS     S S S
SS S S   S S
SSSSSSSSSSSS