SSSSSSSSSSSS
S          S
S SSSSS SSSS
S     S S  S
SSSS SS    S
S    S SS  S
S S SS S SSS
S SS S     S
S    SS SS S
SS S  S S  S
S   S   S  S
SSSSSSSSSSSS