SSSSSSSSSSSS
SSSSSS SSSSS
SSSSS   SSSS
SSSS  S  SSS
SSS  SSS  SS
S   SS     S
SSS  SSS  SS
SSSS  S  SSS
SSSSS   SSSS
SSSSSS SSSSS
SSSSSSSSSSSS