SSSSSSSSSSSS
SS         S
SS  S S S  S
SS SS   SS S
SS   SSS   S
S  S S S S S
S  S   S S S
SS   SSS   S
SS SS   SS S
SS  S S S  S
SS         S
SSSSSSSSSSSS
