RRRRRRRRRRRR
RSSSSSSSSSSR
RS        SR
RS nnnnnn SR
RS n nn n SR
RS        SR
RS        SR
RSSSS SSSSSR
RS        SR
RSSSSSSSSSSR
RRRRRRRRRRRR
