................................
................................
................................
.....................RRRRRRRR...
.....................RRRRRRRR...
.....................RRRRRRRR...
.....................RRRRRRRR...
.....................R.RRRRRR...
................................
................................
................................
................................
................................
................................
................................
................................
................................
................................
................................
................................
................................
................................
................................
................................
......................R.RRRR....
......................RRRRRR....
......................RRRRRR....
......................RRRRRR....
......................RRRRRR....
................................
................................
................................