......................
......................
......................
.RRRRRRRRRRRRRRRRRRRR.
.RRRRRRRRRRRRRRRRRRRR.
.RRRRRRRRRRRRRRRRRRRR.
.RRRRRRRRRRRRRRRRRRRR.
.RRRRRRRRRRRRRRRRRRRR.
.RRRRRRRRRRRRRRRRRRRR.
.RRRRRRRRRRRRRRRRRRRR.
.RRRRRRRRRRRRRRRRRRRR.
................RR.RR.
......................
......................
......................
......................
......................
......................
......................
......................
......................
......................