................................
................................
................................
.....RRR........................
......RR........................
.....RRR........................
...RRRRR........................
...RRRRR........................
...RRRRR........................
...RRRRR........................
................................
................................
................................
................................
................................
................................
................................
................................
................................
................................
...RRRRRRRR..R..................
...RRRRRRRRRRR..................
...RRRRRRRRRRR..................
...RRRRRRRRRRR..................
...RRRRRRRRRRR..................
...RRRRRRRRRRR..................
...RRRRRRRRRRR..................
...RRRRRRRRRRR..................
...RRRRRRRRRRR..................
................................
................................
................................